EA textures/east.xpm
WE textures/west.xpm
NO textures/north.xpm
SO textures/south.xpm
F 220,111,119
C 225,111,200

                                   1
1111111111111111111111111111111111111111
100000000000000000000000000000000000000111
1000000000000000000000000000000000000001
1000000000000000000000000000000000000001
1000000000000000000000000000000000000001
1000000000000000001010000000000000000001
1000000000000000001010000000000000000001
1000000000000000001N10010000000000000001
100000000000000000111001000000000000000111111
1000000000000000000000000000000000000001
1000000000000000000100000000000000000001
1000000000000000000000000000000000000001
1000000000000000000000000000000000000001
1000000000000000000000000000000000000001
1111111111111111111111111111111111111111

